|                                                                                                    |
|                                                                                                    |
|                                                                                                    |
|                                                                                                    |
|                                                                                                    |
|                                                                                                    |
|                                                                                                    |
|                                                                                                    |
|                                                                                                    |
|                                                                                                    |
|                                                                                                    |
|                                                                                                    |
|                                                                                                    |
|                                                                                                    |
|                                                                                                    |
|                                                                                                    |
|===================================================================================^^^^^^^^^^^^^^^^^|
|                                     CaB                                                            |
|                                     CaB                                                            |
|                                     CaB                                                            |
|                                     CaB                                           <--------------->|
|                                     CaB                                                            |
|                                     CaB                                                            |
|                                     CaB                                                            |
|                                     CaB                                                            |
|                              YD     ===============================================================|
|                          <-->========                                                              |
|                             |B aD AD AD                                                            |
|                             |BaaaAAAAAA                                                            |
|                             |BXa ZA XA                                                             |
|                     <------->BBBBBBB                                                               |
|                                  bbbbbbbbbbb                                                       |
|                                                                                                    |
|              <----->                                                                               |
|                                                                                                    |
|                                                                                                    |
|                                                                                                    |
|                                                                                                    |
|^^^^^^^^^^^^^^^^^^^^^^^=============================================================================|
|DDDDDDDDDDDDDDDDDDDDDDD|                                                                            |
|                       |                                                                            |
|                       |                                                                            |
|                       |                                                                            |
|<---->                 |                                                                            |
|                       |                                                                            |
|                       |                                                                            |
|                       |                                                                            |
|                       |                                                                            |
|w                      |                                                                            |
|^^^^^^^^^^^^^^^^^^^^^^^|                                                                            |
|                       |             bbbbbbbbbbaaaaaaaaaaBBBBBBBBBB       Z                         |
|AbAbAbAbAbAbAbAbAbAbAbA|  aaaaaaaaaaaBBBBBBBBBBAAAAAAAAAAbbbbbbbbbbaaaaaaaaaa                       |
|                       c             ========================================                       |
|<---->                 c                                                                            |
|                       c                                                                            |
|                       c                                                                            |
|                       c                                                                            |
|<---->                 c                                                                            |
|                       c                                                                            |
|                       |                                                                            |
|=====                  |                                                                            |
|=========              |            X                          Y                                    |
|========================================================================================^^^^^^^^^^^^|
|                                                                                                    |
|                                                                                                    |
|                                                                                                    |
|                                                                                        <---------->|
|                                                                                                    |
|                                                                                                    |
|                                                                                                    |
|                                                             AAAAAAAAAAAAA==========================|
|                                                                                                    |
|                                                                                                    |
|                            CCCCC                                bbbbb                              |
|                            C   C                                                                   |
|                            C   C                                                                   |
|                            Cy  C                                                                   |
|                            CCCCC                                                                   |
|                                                                                                    |
|                                           *-----*     *                                            |
|                                           =     =     =                                            |
|                                           =     =     =                                            |
|                                           =x    =z    =                                            |
|====================================================================================================|