                                                                                                                              |
                                                                                                                              |
                                                                                                                              |
                                                                                                                              |
                                                                                                                              |
        E                                                                                                                     |
<------------>                                                                                                                |
                                                     ==================                                                       |
                                                     ==================                                                       |
                                                     ==================                                                       |
<----->                                              ==================                                                       |
                                                     ==================                                                       |
                                                     ==================                                                       |
                                                     ==================                                                       |
<----->          ffffffffffffffffffffffffffffffffffff==================                                                       |
                 ======================fff=============================                                                       |
W   ee                                 fff                            =                                                       |
==============================================================================================================================|
==============================================================================================================================|
==============================================================================================================================|
==============================================================================================================================|
==============================================================================================================================|
==============================================================================================================================|