
|                                                 |
|                                                 |
|                                                 | 
|                                                 |
|                                                 |
|                        O                        | 
|                                                 |
|                                        CC   W   |
|                <---->                           |
|                                                 |
|                                                 |
|                           W                     |
|BBBBBBB                                          |
|                                                 |
|                                           Y     |
|                                    <----------->|
|   <--------->                                   |
|                                                 | 
|                                                 |
|                          CCCCCCC   W            |
|           e                                     |
|           e                                     |
|           e    Z                                |
|           e <--------->                         |
|           e                                     |
|                                                 |
|                                                 |
|                                                 |
|<----->                                          |
|                                                 |
|                                                 |
|             E                                   |
|         <------>                                |
|                     <--------->                 |
|                                                 |
|                                                 |
|                                                 |
|                                                 |
|                                                 |
|                                     <-------->  |
|                                                 |
|  bbbbbbbbbb                                     |
|                                                 |
|                                                 |
|           <----->                               |
|                                                 |
|                                                 |
|              y                                  | 
|         <--------->                             |
|                                                 |
|                                                 |
|                                                 |
|                                      ==         |
|             C    WCCffffffff         ==    z    |
===================================================
===================================================