|                                                                                                    |
|                                                                                                    |
|                                                                                                    |
|                                                                                                    |
|                                                                                                    |
|                                                                                                    |
|                                                                                                    |
|                                                                                                    |
|                                                                                                    |
|                                                                                                    |
|                                                                                                    |
|                                                                                                    |
|                                                                                                    |
|                                                                                                    |
|                                                                                                    |
|                                                                                                    |
|                                                                                                    |
|                                                                                                    |
|                                                                                                    |
|                                                                                                    |
|                                                                                                    |
|                                                                                                    |
|                                                                                                    |
|                                                                                                    |
|                                                                                                    |
|                                                                                                    |
|                                                                                                    |
|                                                                                                    |
|                                                                                                    |
|                                                                                                    |
|                                                                                                    |
|                                                                                                    |
|                                                                                                    |
|                                                                                                    |
|                                                                                                    |
|                                                                                                    |
|                                                                                                    |
|                                                                                                    |
|                                                                                                    |
|                                                                                                    |
|                                                                                                    |
|                                                                                                    |
|                                                                                                    |
|                                                                                                    |
|                                                                                                    |
|                                                                                                    |
|                                                                                                    |
|                                                                                                    |
|                                                                                                    |
|                                                                                                    |
|                                                                                                    |
|                                                                                                    |
|                                                                                                    |
|                                                                                                    |
|                                                                                                    |
|                                                                                                    |
|                                                                                                    |
|                                                                                                    |
|                                                                                                    |
|                                                                                                    |
|                                                                                                    |
|^^^^^^^^^^^^^^^^^^^^^^^=============================================================================|
|                       |                                                                            |
|                       |                                                                            |
|<---->                 |                                                                            |
|                       |             bbbbbbbbbbAAAAAAAAAABBBBBBBBBB       Z                         |
|                       |  AAAAAAAAAAABBBBBBBBBBaaaaaaaaaabbbbbbbbbbAAAAAAAAAA                       |
|                       C             bbbbbbbbbbAAAAAAAAAABBBBBBBBBBaaaaaaaaaa                       |
|<---->                 C                                                                            |
|                       C                                                                            |
|                       C                                                                            |
|                       C                                                                            |
|<---->                 C                                                                            |
|                       C                                                                            |
|                       C                                                                            |
|=====                  C                                                                            |
|=========              C            X                          Y                                    |
|========================================================================================^^^^^^^^^^^^|
|                                                                                                    |
|                                                                                                    |
|                                                                                                    |
|                                                                                        <---------->|
|                                                                                                    |
|                                                                                                    |
|                                                                                                    |
|                                                             AAAAAAAAAAAAA==========================|
|                                                                                                    |
|                                                                                                    |
|                            CCCCC                                bbbbb                              |
|                            C   C                                                                   |
|                            C   C                          bbbbb                                    |
|                            Cy  C                                                                   |
|                            CCCCC                                                                   |
|                                                                                                    |
|                                              *-------*                                             |
|                                              =   =   =                                             |
|                                              =   =   =                                             |
|                                              =x  =z  =                                             |
|====================================================================================================|