|                                                                                                    |
|                                                                                                    |
|                                                                                                    |
|                                                                                                    |
|                                                                                                    |
|                                                                                                    |
|                                                                                                    |
|                                                                                                    |
|                                                                                                    |
|                                                                                                    |
|                                                                                                    |
|                                                                                                    |
|                                                                                                    |
|                                                                                                    |
|                                                                                                    |
|                                                                                                    |
|                                                                                                    |
|                                                                                                    |
|                                                                                                    |
|                                                                                                    |
|                                                                                                    |
|                                                                                                    |
|                                                                                                    |
|                                                                                                    |
|                                                                                                    |
|                                                                                                    |
|                                                                                                    |
|                                                                                                    |
|                                                                                                    |
|                                                                                                    |
|                                                                                                    |
|                                                                                                    |
|                                                                                                    |
|                                                                                                    |
|                                                                                                    |
|                                                                                                    |
|                                                                                                    |
|                                                                                                    |
|                                                                                                    |
|                                                                                                    |
|                                                                                                    |
|                                                                                                    |
|                                                                                                    |
|                                                                                                    |
|                                                                                                    |
|                                                                                                    |
|                                                                                                    |
|                                                                                                    |
|                                                                                                    |
|                                                                                                    |
|                                                                                                    |
|                                                                                                    |
|                                                                                                    |
|                                                                                                    |
|                                                                                                    |
|                                                                                                    |
|                                                                                                    |
|                                                                                                    |
|                                                                                                    |
|                                                                                                    |
|                                                                                                    |
|                                                                                                    |
|                                                                                                    |
|                                                                                                    |
|                                                                                                    |
|                                                                          X                         |
|                                                                   AAAAAAAAAA                       |
|                                                                   aaaaaaaaaa                       |
|                                                                                                    |
|========================================================================================^^^^^^^^^^^^|
|                                                                                                    |
|                                                                                                    |
|                                                                                                    |
|                                                                                        <---------->|
|                                                                                                    |
|                                                                                                    |
|                                                                                                    |
|                                                             AAAAAAAAAAAAA==========================|
|                                                                                                    |
|                                                                                                    |
|                            CCCCC                                bbbbb                              |
|                            C   C                                                                   |
|                            C   C                          bbbbb                                    |
|                            Cy  C                                                                   |
|                            CCCCC                                                                   |
|                                                                                                    |
|                                              *-------*                                             |
|                                              =   =   =                                             |
|                                              =   =   =                                             |
|                                              =x  =z  =                                             |
|====================================================================================================|