|                                                                                                    |
|                                                                                                    |
|                                                                                                    |
|                                                                                                    |
|                                                                                                    |
|                                                                                                    |
|                                                                                                    |
|                                                                                                    |
|                                                                                                    |
|                                                                                                    |
|                                                                                                    |
|                                                                                                    |
|                                                                                                    |
|                                                                                                    |
|                                                                                                    |
|                                                                                                    |
|===================================================================================^^^^^^^^^^^^^^^^^|
|                                     CaB                                                            |
|                                     CaB                                                            |
|                                     CaB                                                            |
|                                     CaB                                           <--------------->|
|                                     CaB                                                            |
|                                     CaB                                                            |
|                                     CaB                                                            |
|                                     CaB                                                            |
|                              YD     ===============================================================|
|                          <-->========                                                              |
|                             |B aD AD AD                                                            |
|                             |BaaaAAAAAA                                                            |
|                             |BXa ZA XA                                                             |
|                     <------->BBBBBBB                                                               |
|                                  bbbbbbbbbbb                                                       |
|                                                                                                    |
|              <----->                                                                               |
|                                                                                                    |
|                                                                                                    |
|                                                                                                    |
|                                                                                                    |
|              <----->                                                                               |
|                                                                                                    |
|                                                                                                    |
|                                                                                                    |
|                                                                                                    |
|^^^^^^^^^^^^^^^^^^^^^^^=============================================================================|
|DDDDDDDDDDDDDDDDDDDDDDD|                                                                            |
|                       |                                                                            |
|                       |                                                                            |
|                       |                                                                            |
|<---->                 |                                                                            |
|                       |                                                                            |
|                       |                                                                            |
|                       |                                                                            |
|                       |                                                                            |
|w                      |                                                                            |
|^^^^^^^^^^^^^^^^^^^^^^^|                                                                            |
|                       |             bbbbbbbbbbaaaaaaaaaaBBBBBBBBBB                                 |
|                       |             bbbbbbbbbbaaaaaaaaaaBBBBBBBBBB                                 |
|                       |             bbbbbbbbbbaaaaaaaaaaBBBBBBBBBB       Z                         |
|<---->                 |  aaaaaaaaaaa|BBBBBBBBBAAAAAAAAAAbbbbbbbbbbaaaaaaaaaa                       |
|aaaaaaaaaaaaaaaaaaaaaaa|  aaaaaaaaaaa|BBBBBBBBBAAAAAAAAAAbbbbbbbbbbaaaaaaaaaa                       |
|                       |  aaaaaaaaaaa|BBBBBBBBBAAAAAAAAAAbbbbbbbbbbaaaaaaaaaa                       |
|                       c             |=======================================                       |
|<---->                 c             |                                      |                       |
|                       c             |                                      |                       |
|                       c             |                                      |                       |
|                       c             |                                      |                       |
|<---->                 c             |                                      |                       |
|                       c             <-------------------------------------->                       |
|                       |                                                                            |
|                       |                                                                            |
|                       |                                                                            |
|=====                  |                                                                            |
|=========              |             *    X                    Y            *                       |
|========================================================================================^^^^^^^^^^^^|
|                                                                                                    |
|                                                                                                    |
|                                                                                                    |
|                                                                                        <---------->|
|                                                                                                    |
|                                                                                                    |
|                                                                                                    |
|                                                             ACACACACACACA==========================|
|                                                                                                    |
|                                                                                                    |
|                                                                 bbbbb                              |
|                                                                 CCCCC                              |
|                                                                 C   C                              |
|                                           =-----=               C   C                              |
|                                           =     =               Cy  C                              |
|                                           =     =               CCCCC                              |
|                                           =     =                                                  |
|                                      <---------->     *                                            |
|                                           =     =     =                                            |
|                                           =     =     =                                            |
|                                           =x    =z    =                                            |
|====================================================================================================|