|                                                            |
|                                                            |
|                                                            |
|                                                            |
| eeee                                                       |
|                                                            |
|         E     E     E                                      |
|        PPP   PPP   PPP                                     |
|                                                            |
|                        PPP               PP   P   PP       |
|PP                                                          |
|PPP                                                         |
|PPPPPP                        PPP    PP               eee   |
|PPPPPPP                                                     |
|PPPP PPPPP                                                  |
|PP      PPPP                                                |
|P                                                 PPP       |
|                                                            |
|                                                        E   |
|                                                       PPP  |
|                   PP    PP    PPP               PPP        |
|E                                P                          |
|PPP          eee                 PPP E     PPP              |
|PPPPP                               PPPP                    |
|         PP                                                 |
|                                                            |
|                                                            |
|PPPPPPP   PPP                                               |
|PPP             E               eee                         |
|P              PPP   PPP                         PP         |
|                                     PPP         PP         |
|                                     PPP     PPPPPPPPPPPP   |
|                           PPP       PPP     PP             |
|                                     PPP     PP             |
|                                     PPPE  PPPP            P|
|                                     PPPPPP               PP|
|                                                         PPP|
|                                                        PPPP|
|                                                            |
|                                                            |
|                      PPPP                          eee     |
|                     PPPPP E         E   E  E   E           |
|                    PPPPPPPPPP    PPPPPPPPPPPPPPPP          |
|                   PPPPPPPPPPP    PPPPPPPPPPPPPPPP          |
|                  PPPPPPPPPPPP    PPPP                      |
|                PPPPPPPPPPPPPP    PPP                       |
|                                                            |
|                                                            |
|         eee                                                |
|                                                            |
|                                                            |
|PPPPPP        PPP                                   PPP     |
|PPPPPP                           PPPPPPPPPPPPPPPPPPPPPPPPPPP|
|P                          PPPPPPPPPPPPPPPPPPPPPPPPPPPPPPPPP|
|P                          PPPPPPPPPPPPPPPPPPPPPPPPPPPPPPPPP|
|PPPPPP   PPP              PP  PPP           PPPPPPP     PPPP|
|                     PPPPPP                   PP          PP|
|               PPP                                          |
|                                                            |
|          E                                                 |
|         PPP                                                |
|                                                            |
|             PPP                                            |
|                                                            |
|       PPP                                                  |
|                                                            |
|E                                                           |
|PPPP                                                        |
|                                                            |
|                   P P P P  PPP                             |
|     PPP                        eeee                        |
|                E               PPP                         |
|          eee  PPP                                          |
|                                                            |
|                                 PPP                        |
|                                       E                    |
|                 PPPPPPPPPPPPPPP      PPP                   |
|PPPPPPPPPPPPPPPPPPPPPPPPPPPPPP                              |
|PPPPPPPPPPPPPPPPPP                                          |
|PPPPP                                      PPP   PPP        |
|P                                                           |
|                                                            |
|                                                       ee   |
|                                                            |
|                                                            |
|                                                   PPP      |
|                                                            |
|                                              eee           |
|                                          E                 |
|                                        PPPP                |
|                                    PPP                     |
|                                PPP                         |
|                       PPPPPPPP                             |
|PPPPPPPPPPPPPPPPPPPPPPPPPPPPPPPPPPPPPPPPPPPPPPPPPPPPPPPPPPPP|
|PPPPPPPPPPPPPPPPPPPPPPPPPPPPPPPPPPPPPPPPPPPPPPPPPPPPPPPPPPPP|